***S******.**T.
.**.....**.***.
.*..******...*.
...****....*...
.*....****.*.**
.*.**...**.*..*
...*..****.**.*
**...*.*.*..*..
****.......****