.*...........*.....
.*.*******.***.***.
.*...*...*.....*...
.***.*.*.*******.**
.....*S*.*.....*...
.*******.*.***.*.*.
.*.......*.*...*.*.
.***.*****.*.*****.
.....*...*.*.*...*.
****.*.*.*.*.*.*.*.
.*...*.*...*...*...
.*.***.*****.******
.....*...*...*.....
.*******.*****.***.
...*...*.......*...
****.*.***.*****.*.
.....*...*...*...*.
.*******.*****.***.
T*.............*...