.........*...........
******.*.*****.*****.
.......*.....*.*T....
.***********.*.******
.....*.*.......*.....
.***.*.*.*******.***.
.*...*.....*.......*.
.*.*******.*.*******.
.*.......*.*...*...*.
.*******.*****.*.*.*.
.*.....*...*...*.*.*.
**.***.***.*.***.*.*.
...*.*...*...*...*...
.***.***.*****.******
.*.*...*.....*.......
.*.*.*.*****.*******.
.*.*.*...*...*...*...
.*.*.*.*.*.***.*.*.*.
.*.*.*.*.*.*...*...*.
.*.*.*.***.***.*****.
S....*.........*.....