...*...*.......*.......*...*...
.*.*.*.*.*****.*.*.***.*.***.*.
.*...*...*...*.*.*.*.....*...*.
.*********.***.*.*.***.***.***.
.*...*.......*.*.*...*.*...*...
.*.***.*****.*.*.***.***.***.*.
.*...*.*...*...*.*.*.*...*...*.
.***.*.***.*****.*.*.*.***.****
...*.........*.....*.....*.....
.*.*********.*.*************.*.
.*...*.....*.*T*...*.......*.*.
.***.*.*****.***.*.*.*****.***.
.*...*...........*.*...*...*...
.*.***.***********.***.*.***.**
.*...*...*.*...*.*.*...*...*...
****.***.*.*.*.*.*.*.*****.***.
.....*.....*.*.*...*.*...*.....
.***********.*.*.***.*.*******.
.............*.*.*...*.....*...
.*************.*.*.*.***.***.**
.*.........*...*.*.*...*.*...*.
.*.*****.***.***.*****.*.*.***.
.*.*.....*...*.*.....*.*.*.....
.***.*.***.***.*****.*.*.*****.
.....*.*...*...*.....*.*.*.....
******.*.***.*.*.*****.*.*.****
.......*...*.*.*.*.....*.*.....
.*********.*.***.***.***.*****.
.*.........*...*.*...*.........
**.*********.*.*.*.***.********
S..*.........*.....*...........